PBBBBBBBBBBBBBBBB
PBBBBBPPPBPPPBPPP
PPPBPPPBPPPBPPPBP
BBPBPBBBBBBBBBBPP
BPPBPPBBPPPPPBPPB
BPBBBPBBPBBBPPPBB
BPBBBPBBPBBBBBBBB
BPBBBPBBPBBBPPPBB
BPPPPPBBPPPPPBPPP
BBBBBBBBBBBBBBBBB
