P00017B00---B00---B00---B00---B00---B00---B00---B00---B00---B00---B00---B00---B00---B00---B00---B00---
P00034B00---B00---B00---B00---B00---P00024P00025P00042B00---P00028P00029P00046B00---P00032P00033P00050
P00035P00036P00053B00---P00039P00040P00023B00---P00043P00044P00027B00---P00047P00048P00031B00---P00067
B00---B00---P00070B00---P00038B00---B00---B00---B00---B00---B00---B00---B00---B00---B00---P00083P00066
B00---P00086P00069B00---P00055P00072B00---B00---P00093P00076P00077P00078P00079B00---P00099P00082B00---
B00---P00103B00---B00---B00---P00073B00---B00---P00110B00---B00---B00---P00080P00097P00098B00---B00---
B00---P00120B00---B00---B00---P00090B00---B00---P00127B00---B00---B00---B00---B00---B00---B00---B00---
B00---P00137B00---B00---B00---P00107B00---B00---P00144B00---B00---B00---P00132P00133P00150B00---B00---
B00---P00138P00139P00140P00141P00124B00---B00---P00145P00146P00147P00148P00131B00---P00151P00152P00170
B00---B00---B00---B00---B00---B00---B00---B00---B00---B00---B00---B00---B00---B00---B00---B00---B00---
