P00000B00   B00   B00   B00   B00   B00   B00   B00   B00   B00   B00   B00   B00   B00   B00   B00   
P00000B00   B00   B00   B00   B00   P00000P00000P00000B00   P00000P00000P00000B00   P00000P00000P00000
P00000P00000P00000B00   P00000P00000P00000B00   P00000P00000P00000B00   P00000P00000P00000B00   P00000
B00   B00   P00000B00   P00000B00   B00   B00   B00   B00   B00   B00   B00   B00   B00   P00000P00000
B00   P00000P00000B00   P00000P00000B00   B00   P00000P00000P00000P00000P00000B00   P00000P00000B00   
B00   P00000B00   B00   B00   P00000B00   B00   P00000B00   B00   B00   P00000P00000P00000B00   B00   
B00   P00000B00   B00   B00   P00000B00   B00   P00000B00   B00   B00   B00   B00   B00   B00   B00   
B00   P00000B00   B00   B00   P00000B00   B00   P00000B00   B00   B00   P00000P00000P00000B00   B00   
B00   P00000P00000P00000P00000P00000B00   B00   P00000P00000P00000P00000P00000B00   P00000P00000P00000
B00   B00   B00   B00   B00   B00   B00   B00   B00   B00   B00   B00   B00   B00   B00   B00   B00   
